%%%%%%%%%%%%%%%%%%%%%%%%%%%%%%%%%%%%%%%%%%%%%%%%%
%                                               %
%                                               %
%                                               %
%                                               %
%                                               %
%                                               %
%        %%%%%%%%%%%%%%%%%%%%%%%%%%%%%%%        %
%        %                             %        %
%        %                             %        %
%        %                             %        %
%        %                             %        %
%        %                             %        %
%        %                             %        %
%        %                             %        %
%        %                             %        %
%        %                             %        %
%        %                             %        %
%        %                             %        %
%        %                             %        %
%        %                             %        %
%        %                             %        %
%        %                             %        %
%        %                             %        %
%        %                             %        %
%        %                             %        %
%        %                             %        %
%        %                             %        %
%        %                             %        %
%        %                             %        %
%        %                             %        %
%        %                             %        %
%        %                             %        %
%        %                             %        %
%        %                             %        %
%        %                             %        %
%        %%%%%%%%%%%%%%%%%%%%%%%%%%%%%%%        %
%                      .%  #                    %
%                      .%  #                    %
%                      .%  #                    %
%                      .%  #                    %
%                      .%  #                    %
%                      .%  #                    %
%%%%%%%%%%%%%%%%%%%%%%%%%%%%%%%%%%%%%%%%%%%%%%%%%
