%%%%%%%%%%%
% .       %
%     .   %
%         %
%  G      %
%      .  %
%  .      %
%         %
%      P  %
%         %
%   .     %
%%%%%%%%%%%
