%%%%%%%%%%%%%%%%
%..%........%..%
%..............%
%..............%
%....%%%%%.....%
%.%....G.....%.%
%....%%%%%.....%
%........P.....%
%.%%%.....%%%%.%
%..............%
%..%........%..%
%%%%%%%%%%%%%%%%
