%%%%%%%%%%%%%%%%%%%%%%%%%%%
%    %     ....      %    %
%   ..     ....      ..   %
% %%%%%%%         %%%%%%% %
%....                 ....%
% %  .               .  % %
%       %%%%%%%%%%        %
% %%%        .G       %%% %
%       %%%%%%%%%%        %
% %  .               .  % %
%....            P    ....%
% %%%%%%%         %%%%%%% %
%   ..     ....      ..   %
%    %               %    %
%%%%%%%%%%%%%%%%%%%%%%%%%%%
