%%%%%%%%%%%%%%%%%%%%%%%%%%%
%    %      ...      %    %
%   ..     ....      ..   %
% %%%%%%%         %%%%%%% %
%....                 ....%
% %  .               .  % %
%       %%%%%%%%%%        %
% %%%        .G       %%% %
%       %%%%%%%%%%        %
% %  .               .  % %
%....                 ....%
% %%%%%%%         %%%%%%% %
%   ..     ....      ..   %
%    %      P        %    %
%%%%%%%%%%%%%%%%%%%%%%%%%%%
