%%%%%%%%%%%%%%
%            %
%            %
%    P       %
%            %
%            %
%        .   %
%            %
%            %
%            %
%%%%%%%%%%%%%%
