%%%%%%%%%%%%%%%%%%%%%
%   P               %
%                   %
%                   %
%                   %
%   .               %
%                   %
%       .           %
%                   %
%                   %
%                   %
%              .    %
%                   %
%                   %
%                   %
%                   %
%                  .%
%%%%%%%%%%%%%%%%%%%%%
