%%%%%%%%%%%%%%%
%         ....%
%         ....%
%     ########%
%     ########%
%     ########%
%     ########%
%         ....%
%       P ....%
%%%%%%%%%%%%%%%
