%%%%%%%%%%%%%%%%
%..%........%..%
%..............%
%..............%
%....%%%%%.....%
%.%.....G....%.%
%....%%%%%.....%
%..............%
%.%%%.....%%%%.%
%..............%
%..%........%..%
%%%%%%%%%%%%%%%%
