%%%%%%%
% P   %
% %.  %
% %%% %
%%%%%%%
